#######################################################
#         #         #         #     #   #     #       #
#######   #         #   ####  #  ####   # ### ######  #
#           ##   ## #         #                       #
#  ####     ### ### #  ####   #  #####  ####          #
#                      #                   #    #     #
#  ####   ####     #####  #   #####             #     #
#     #         #         #   #                 # #   #
#  ## ###   #   #####   ###   #####   ######### # #   #
#           #                         #         #     #
######   ##   ####### #######     #       #############
#             #                   #                   #
#   #######   #     #######  ######       #  #  #  ####
#                         #               #  #  #     #
#   #####       ### ####  #  ##########   ####  ###   #
# #     #       #     #                   #           #
# #     #  #  # ####  #           #####   #   #   #   #
# #     #  #  #   #   #       #       #   #   #   #   #
# #     #  #  #  ##   ####    #     ###   #   #   #   #
# #           #               # #   #     #   #   #   #
#       #######   ####      #####   # ##  #   #  ###  #
#     #                             #         #       #
#######################################################